3 10 3 // TankHP TankAmmo TankRange
2 1     // BridgeHP BlockHP
-|      // BridgeIDs
UVXYZ   // BlockIDs
ab      // HeadquarterIDs
AB      // PlayerIDs (TankIDs)
10      // LandID WaterID
0000000000000000001a
01111111111111Z11110
00111111111111Z11100
000000011AA110000000
01111111111111111110
01111111111111111110
0B111111111111111110
0111UU11111111111110
0000|||||00000000000
0B11XX11111000000000
00000000011111YY11A0
00000000000|||||0000
01111111111111VV1110
011111111111111111A0
01111111111111111110
01111111111111111110
000000011BB110000000
00111Z11111111111100
01111Z11111111111110
b1000000000000000000
