3 10 3 // TankHP TankAmmo TankRange
2 1     // BridgeHP BlockHP
-|      // BridgeIDs
UVXYZ   // BlockIDs
ab      // HeadquarterIDs
AB      // PlayerIDs (TankIDs)
10      // LandID WaterID
0000000000000000001a
11111111111111111111
11111111111111111111
00000001111110000000
11111111111111111111
11111111111111111111
0B111111111111111111
0111UU11111111111110
0000|||||00000000000
0B11XX11111000000000
00000000011111YY11A0
00000000000|||||0000
00111111111111VV1110
111111111111111111A0
11111111111111111111
11111111111111111111
00000001111110000000
11111111111111111111
11111111111111111111
b1000000000000000000
