3 10 3 // TankHP TankAmmo TankRange
2 1     // BridgeHP BlockHP
-|      // BridgeIDs
UVWXYZST  // BlockIDs
ab      // HeadquarterIDs
AB      // PlayerIDs (TankIDs)
10      // LandID WaterID
1000    // Maximum numer of steps
B111111111111111111A
1SSSSSSSS11SSSSSSSS1
0T0000000||0000000T0
0T0111111111111110T0
0T010|00000000|010T0
0T01011X1111X11010T0
0T01010|0000|01010T0
0T0101011111101010T0
1T010101UUUU101010T1
11-10101Ua1U10101-11
11-10101U1bU10101-11
1T010101UUUU101010T1
0T0101011111101010T0
0T01010|0000|01010T0
0T01011V1111V11010T0
0T010|00000000|010T0
0T0111111111111110T0
0T0000000||0000000T0
1SSSSSSSS11SSSSSSSS1
A111111111111111111B
